NO ./assets/textures/jungle.xpm
SO ./assets/textures/jungle_brick.xpm
EA ./assets/textures/stone.xpm
WE ./assets/textures/stone.xpm
C 100,100,100
F 170,170,170

1111111111111111111111111111111111111111111111111111111111111111
1000000000000001000000000000001000000000000000001000000000000001
100000000000000C00000000000000C00000000000000000C000000000000001
1000000000000001000000000000001000000000000000001000000000000001
100000110000011111111111111111111111110001111111111C11111111C111
1000001100000111111111111111111111111100010011111100011111100011
100000110000000000000000000000000111111C110010000000000000000001
1000001100000000000000000000000001100100011000000000000000000001
1000001100000000000000000000000001100100011010000000000000000001
1000001100000111111111111111111011111100011111111111111111111111
1000001100000100000000111111100001100000001111000000000000000001
1000001100000C00000000111111100001111100011111000000000000000001
1000001100000100000000110001100001111100011111000000000000000001
1000001111111111111111110001111111111100011111111111111111111111
100000100000111111111111000111111111111C111111111111111111111111
1000001000001100000000011C11000000001100010000000000000000000011
1000001000001100000000010001000000001100010000000000000000000011
10000000000011000000000C000C000000001100010000000000000000000001
1000000000001100000000010001000000001100010000000000000000000011
10000010000011000000000C000C000000001100010000000000000000000001
10000010000011000000000100010000000001000111111C111111111C111111
11111C1111111100000000110001100000000100010000000000000000000001
1110000011111111111111100000111111111100010000000000000000000001
1110000011000100000000000000000000000100010000000000000000000001
1010000011000000000000000000000000000C00010000000000000000000001
1000000011000100000000000000000000000100010000000000000000000001
1010000011000111111000000000000011111100010000000000000000000001
1110000011000000011111111C111111100001000111C111111111111111C111
1110000011000000011000010001000010000100010000000000000000000001
1111111111111111C110000C000C000010000100010000000000000000000001
1111111111111110001000010001000010000100010000000000000000000001
1011110000100010001111110001111110000100011000000000000000000001
1000010000100010001000010001000010000100011000000000000000000001
10000111C111C1100010000C000C000010000100011000000000000000000001
1000000000000010001000010001000010000100011000000000000000000001
10000000000000C0001111110001111110000100011110001100011110001111
1000000000000010001000010001000010000100011111C1111C111111C11111
10000111C111C1100010000C000C000011110100000000000000011000000011
1000010000100010001000010N01000011100100000000000000011000000111
1000010000100011111111111111111111111100000000000000011000000011
1111111111111111111111111111111111111111111111111111111111111111
