1111111111111111111111111111111111111111111111111111111111111111
1000000000000001000000000000001000000000000000001000000000000001
1000000000000000000000000000000000000000000000000000000000000001
1000000000000001000000000000001000000000000000001000000000000001
1000001100000111111111111111111111111100011111111110111111110111
1000001100000111111111111111111111111100010011111100011111100011
1000001100000000000000000000000001111110110010000000000000000001
1000001100000000000000000000000001100100011000000000000000000001
1000001100000000000000000000000001100100011010000000000000000001
1000001100000111111111111111111011111100011111111111111111111111
1000001100000100000000111111100001100000001111000000000000000001
1000001100000000000000111111100001111100011111000000000000000001
1000001100000100000000110001100001111100011111000000000000000001
1000001111111111111111110001111111111100011111111111111111111111
1000001000001111111111110001111111111110111111111111111111111111
1000001000001100000000011011000000001100010000000000000000000011
1000001000001100000000010001000000001100010000000000000000000011
1000000000001100000000000000000000001100010000000000000000000001
1000000000001100000000010001000000001100010000000000000000000011
1000001000001100000000000000000000001100010000000000000000000001
1000001000001100000000010001000000000100011111101111111110111111
1111101111111100000000110001100000000100010000000000000000000001
1110000011111111111111100000111111111100010000000000000000000001
1110000011000100000000000000000000000100010000000000000000000001
1010000011000000000000000000000000000000010000000000000000000001
1000000011000100000000000000000000000100010000000000000000000001
1010000011000111111000000000000011111100010000000000000000000001
1110000011000000011111111011111110000100011101111111111111110111
1110000011000000011000010001000010000100010000000000000000000001
1111111111111111011000000000000010000100010000000000000000000001
1111111111111110001000010001000010000100010000000000000000000001
1011110000100010001111110001111110000100011000000000000000000001
1000010000100010001000010001000010000100011000000000000000000001
1000011101110110001000000000000010000100011000000000000000000001
1000000000000010001000010001000010000100011000000000000000000001
1000000000000000001111110001111110000100011110001100011110001111
1000000000000010001000010001000010000100011111011110111111011111
1000011101110110001000000000000011110100000000000000011000000011
1000010000100010001000010001000011100100000000000000011000000111
1000010000100011111111111111111111111100000000000000011000000011
1111111111111111111111111111111111111111111111111111111111111111
